0, 0, 0, 0, 0, 0, 1, 1, 1, 1, 1, 1, 1, 1, 1, 1,1,1,1,1,1,1,1,1,1,
0, 1, 1, 1, 1, 1, 1, 0, 4, 4, 0, 2, 0, 0, 0, 0,1,1,1,1,1,1,1,1,1,
1, 1, 0, 0, 0, 0, 4, 4, 3, 3, 3, 3, 3, 3, 3, 3,1,1,1,1,1,1,1,1,1,
0, 1, 0, 0, 2, 0, 3, 3, 3, 0, 1, 1, 1, 0, 0, 0,1,1,1,1,1,1,1,1,1,
0, 1, 1, 0, 3, 3, 3, 0, 0, 0, 1, 1, 1, 2, 0, 0,1,1,1,1,1,1,1,1,1,
0, 0, 1, 0, 3, 0, 6, 6, 0, 0, 1, 1, 1, 1, 2, 0,1,1,1,1,1,1,1,1,1,
2, 0, 1, 0, 3, 0, 2, 2, 2, 0, 1, 1, 5, 5, 6, 6,1,1,1,1,1,1,1,1,1,
0, 0, 1, 0, 3, 5, 5, 2, 0, 0, 0, 0, 1, 1, 1, 1,1,1,1,1,1,1,1,1,1,
