1, 2, 3, 3, 4, 5, 5, 1, 1, 1, 1, 2, 6, 7, 8,8,8,7,4,5,7,4,3,2,10
9, 2, 3, 3, 4, 5, 5, 1, 1, 1, 1, 2, 6, 7, 8,8,8,7,4,5,7,4,3,2,10
10, 2, 3, 3, 11, 5, 5, 4, 1, 1, 1, 2, 6, 7, 8,8,8,7,4,5,7,4,3,2,10
1, 2, 3, 3, 4, 5, 5, 1, 1, 1, 1, 2, 6, 7, 8,8,8,7,4,5,7,4,3,2,10
1, 2, 3, 3, 4, 5, 5, 1, 1, 1, 1, 2, 6, 7, 8,8,8,7,4,5,7,4,3,2,10
1, 2, 3, 3, 4, 5, 5, 1, 1, 1, 4, 2, 6, 7, 8,8,8,7,4,5,7,4,3,2,10
1, 2, 3, 3, 4, 5, 5, 3, 1, 1, 1, 2, 6, 7, 8,8,8,7,4,5,7,4,3,2,10
1, 2, 3, 3, 4, 5, 5, 1, 1, 1, 1, 2, 6, 7, 8,8,8,7,4,5,7,4,3,2,10
